11111111111111111111111111
10000000000000P00000000001
10C0C10001111101010001001
10000011111000111E000001
11111111111111111111111