11111111111111
1C000000000001
10000000P00E01
11111100001111
11100000001C11
11111111111111