1111111111111111111
1CC10000C00C10000C1
1000011111001100001
101010000CCC0000011
1P0011E000001000111
1111111111111111111